XXXX
X  XXXX
X . . X
X **X@X
XX    X
 XXXXXX
